1111111111111111111
1000000000000000001
1001111111111111101
1001201000100000101
1000100010001000101
1010111111111110101
1010000000000010101
1011111111111010001
1000000000000010101
1011111111100010101
1000000000000000101
1111111111111111111